111111111111
100011010101
111010000001
110000111101
110111111100
110101111111
110001111111
111101110101
110000000001
111111111111